0000000000
0110000000
0110000000
0000110000
00001100000001111
000001100000011110
0000011000
0011110000
0011111100
0011111100